{
    "pokerAmount" : 18 ,
    "mapSizeW" :  8,
    "mapSizeH" :  8,
    "pokerSize" : 2 ,
    "pokerTypeNum" : 3,
    "pokerList" : [
        [3,4,1],
        [5,4,1],
        [1,1,1],
        [3,1,2],
        [5,1,2],
        [7,1,2],
        [1,3,3],
        [3,3,3],
        [5,3,3],
        [7,3,4],
        [1,5,4],
        [3,5,4],
        [5,5,5],
        [7,5,5],
        [1,7,5],
        [3,7,6],
        [5,7,6],
        [7,7,6]
    ]
}